







NO textures/north.png








SO textures/south.png
                        WE textures/west.png
        EA textures/east.png

        F 160,           130,             85
C 100,          200,255

        1111111111111111111111111
        1000000000110000000000001
        1011000001110000000000001
        1001000000000000000000001
111111111001000001110000000000001
100000000010000001110111110111111
11110111111111011100000010001
11110111111111011101010010001
11000000110101011100000010001
10000000000000001100011110S01
10000000000000001101010000001
1100000111010101111101111000111
11110111 1110101 101111010001
11111111 1111111 111111111111
